(| G | _ | _ | _ | _ |)
(| _ | P | _ | _ | _ |)
(| _ | _ | _ | _ | _ |)
(| _ | S | _ | _ | _ |)
(| _ | _ | _ | _ | _ |)
