(1  2  3  4  5)
(1 .  P  .  .  .)
(2 .  .  .  S  .)
(3 .  .  .  .  G)
(4 .  .  .  .  .)
(5 .  .  .  .  .)
