(    1   2   3   4   5  (column))
(  +---+---+---+---+---+)
(1 | A |   |   |   |   |)
(  +---+---+---+---+---+)
(2 |   |   |   | S |   |)
(  +---+---+---+---+---+)
(3 |   |   |   |   |   |)
(  +---+---+---+---+---+)
(4 |   |   | G |   |   |)
(  +---+---+---+---+---+)
(5 |   |   |   |   |   |)
(  +---+---+---+---+---+)
(  (row))
