(     1  2  3  4  5)
(1    .  .  .  .  .)
(2    .  .  .  S  .)
(3    .  .  .  .  .)
(4    G  .  .  .  .)
(5    .  .  .  .  P)
