(1 _ _ _ _ _)
(2 _ _ _ _ P)
(3 _ S _ _ _)
(4 _ _ _ _ _)
(5 _ _ _ _ _)
