(. . . P .)
(. . . . .)
(. . . . .)
(. . S . .)
(. . . G .)
