(   1  2  3  4  5)
(1  .  .  P  .  .)
(2  .  .  .  .  .)
(3  .  .  .  S  .)
(4  .  .  .  .  .)
(5  G  .  .  .  .)
