(1 [ ] [ ] [ ] [ ] [ ])
(2 [ ] [ ] [ ] [p] [ ])
(3 [ ] [s] [ ] [ ] [ ])
(4 [ ] [ ] [ ] [ ] [ ])
(5 [ ] [ ] [ ] [ ] [G])
