(1 . . . . .)
(2 . . . . .)
(3 G S . . .)
(4 . . . . P)
(5 . . . . .)
