(   1  2  3  4  5)
(1  .  .  .  .  .)
(2  .  .  .  .  .)
(3  .  .  .  .  .)
(4  .  .  S  P  .)
(5  G  .  .  .  .)
