(  1  2  3  4  5)
(1 .  G  .  .  .)
(2 .  .  .  S  .)
(3 .  .  .  .  .)
(4 .  .  .  .  .)
(5 .  .  .  .  P)
