(1 2 3 4 5)
(1 . . . . .)
(2 . . . . .)
(3 . S G . .)
(4 . . . . P)
(5 . . . . .)
