(1 2 3 4 5)
(1 . . . . .)
(2 . P . . .)
(3 . S G . .)
(4 . . . . .)
(5 . . . . .)
