(    1   2   3   4   5)
(  +---+---+---+---+---+)
(1 |   |   |   |   |   |)
(  +---+---+---+---+---+)
(2 |   |   |   |   |   |)
(  +---+---+---+---+---+)
(3 |   |   |   | G |   |)
(  +---+---+---+---+---+)
(4 |   | S |   |   |   |)
(  +---+---+---+---+---+)
(5 |   |   |   | P |   |)
(  +---+---+---+---+---+)
