(   1  2  3  4  5)
(1  .  .  G  .  .)
(2  .  .  .  .  .)
(3  .  .  S  .  .)
(4  P  .  .  .  .)
(5  .  .  .  .  .)
